┼┼┼┼┼┼┼┼┼┼┼┼┼┼┼┼┼┼┼┼┼┼┼┼┼
╆┷┷┷┷╅╆┷┷┷┷┷┷┷╅╆┷┷┷┷┷┷┷╅┼
┨    ┠┨       ┠┨      $┠┼
╄┯┯┓ ┠╄┯┯┓ ┏┯┯╃┨ ┏┓ ┏┓ ┠┼
╆┷┷┛ ┗┷┷┷┛ ┗┷┷┷┛ ┠┨ ┠┨ ┠┼
┨                ┠┨ ┠┨ ┠┼
╄┯┯┓ ┏┯┯┯┓ ┏┓ ┏┯┯╃╄┯╃┨ ┠┼
╆┷┷┛ ┠╆┷┷┛ ┠┨ ┠╆┷┷┷┷┷┛ ┠┼
┨    ┠┨    ┠┨ ┠┨       ┠┼
╄┯┯┓ ┠╄┯┯┓ ┠╄┯╃┨ ┏┯┯┯┓ ┠┼
╆┷┷┛ ┠╆┷┷┛ ┠╆┷┷┛ ┠╆┷┷┛ ┠┼
┨    ┠┨    ┠┨    ┠┨    ┠┼
┨ ┏┯┯╃╄┯┯┓ ┠╄┯┯┓ ┠╄┯┯┓ ┠┼
┨ ┠╆┷┷┷┷┷┛ ┗┷┷╅┨ ┗┷┷┷┛ ┠┼
┨ ┠┨          ┠┨       ┠┼
┨ ┠┨ ┏┯┯┯┓ ┏┯┯╃┨ ┏┓ ┏┓ ┠┼
┨ ┠┨ ┗┷┷┷┛ ┠╆┷┷┛ ┠┨ ┠┨ ┠┼
┨ ┠┨       ┠┨    ┠┨ ┠┨ ┠┼
╄┯╃┨ ┏┓ ┏┓ ┠┨ ┏┓ ┠╄┯╃┨ ┠┼
╆┷┷┛ ┠┨ ┠┨ ┠┨ ┠┨ ┠╆┷┷┛ ┠┼
┨    ┠┨ ┠┨ ┠┨ ┠┨ ┠┨    ┠┼
┨ ┏┯┯╃┨ ┠╄┯╃╄┯╃╄┯╃┨ ┏┯┯╃┼
┨ ┠╆┷┷┛ ┗┷┷┷┷┷╅╆┷┷┛ ┗┷┷╅┼
┨*┠┨          ┠┨       ┠┼
╄┯╃╄┯┯┯┯┯┯┯┯┯┯╃╄┯┯┯┯┯┯┯╃┼